WWWWWWWWWWWWWWWWWWWWWWWWWWWWWWWWWWWWWWWWWWWWWWWWWWWWWWWWWWWWWWWWWWWWWWWWWWWWWWWWW
W00000000000000000S0000000000000000000000000000000000000000000S00000000000000000W
W0WWWWWWWWWWWWWWWWWWWWWWWWWWWWW000WWWWWWWWWWWWWWWWWWWWWWWWWWWWW000WWWWWWWWWWWW00W
W0WWWWWWWWWWWWWWWWWWWWWWWWWWWWW000WWWWWWWWWWWWWWWWWWWWWWWWWWWWW000WWWWWWWWWWWW00W
W0WWWWWWWWWWWWWWWWWWWWWWWWWWWWW000WWWWWWWWWWWWWWWWWWWWWWWWWWWWW000WWWWWWWWWWWW00W
W000000000000000000000000000000000000S000000000000000000000000000000000S00000000W
W0000000000000000000000000000000000000000000000000000000000000000000000000000000W
WWW000WWWWWWWWWWW000WWWWWWWWWWWWWWWWWWW000WWWWWWWWWWWWWWWW000WWWWWWWWWWWWWWWWWW0W
WWW000WWWWWWWWWWW000WWWWWWWWWWWWWWWWWWW000WWWWWWWWWWWWWWWW000WWWWWWWWWWWWWWWWWW0W
WWW000WWWWWWWWWWW000WWWWWWWWWWWWWWWWWWW000WWWWWWWWWWWWWWWW000WWWWWWWWWWWWWWWWWW0W
W0000000000000000000000000000000000000000000000000000000000000000000000000000000W
W00000000000S000000000000000000000000000000S00000000000000000000S000000000000000W
W0000000000000000000000000000000000000000000000000000000000000000000000000000000W
W00000WWWWWWWWWWWWWWWWWWWWWWWWWWWWWWWWWWWWW00000000WWWWWWWWWWWWWWWWWWWWWWWWWWWWWW
W00000WWWWWWWWWWWWWWWWWWWWWWWWWWWWWWWWWWWWW00000000WWWWWWWWWWWWWWWWWWWWWWWWWWWWWW
W00000WWWWWWWWWWWWWWWWWWWWWWWWWWWWWWWWWWWWW00000000WWWWWWWWWWWWWWWWWWWWWWWWWWWWWW
W00000WWWWWWWWWWWWWWWWWWWWWWWWWWWWWWWWWWWWW00000000WWWWWWWWWWWWWWWWWWWWWWWWWWWWWW
W000000000000000000000000000000000000000000000000S000000000000000000000000000000W
W0000000000000000000000000000000000000000000000000000000000000000000000000000000W
W0000000000000S00000000000000000WWWWWW0000WWWWWW00000000000000000000000000000000W
W0000WWWWWWWWWWWWWWWWWWWWWWW0000W0WWW000000WWW0W00000000000WWW00WWW0WWWWW0000000W
W0000WWWWWWWWWWWWWWWWWWWWWWW0000W00000000000000W00000000000WWW00WWW0WWWWW0000000W
W0000WWWWWWWWWWWWWWWWWWWWWWW0000WW0000WWWW0000WW00000000000000000000WWWWW0000000W
W0000WWWWWWWWWWWWWWWWWWWWWWW0000WW0000WWWW0000WW00000000000WWW00WWW0WWWWW0000000W
W0000WWWWWWWWWWWWWWWWWWWWWWW0000WW0000WWWW0000WW00000000000WWW00WWW0WWWWW0000000W
W0000WWWWWWWWWWWWWWWWWWWWWWW0000W00000000000000W00000000000000000000WWWWW0000000W
W00000000000000000000000000S0000W0WWW000000WWW0W00000000000WWW00WWW0WWWWW0000000W
W0000000000000000000000000000000WWWWWW0000WWWWWW00000000000WWW00WWW0WWWWW0000000W
W0000000000000000000000000000000000000000000000000000000000000000000WWWWW0000000W
W00000000S0000000000000000000000000000000000000000000000000000000000WWWWW0000000W
W0000000000WWWWWWWW000000WWWWWWWW000000WWWWWWWW0000000000WWWWWWWWWWWWWWWW0000000W
W0000000000WWWWWWWW000000WWWWWWWW000000WWWWWWWW0000000000WWWWWWWWWWWWWWWW0000000W
W0000000000WWWWWWWW000S00WWWWWWWW000000WWWWWWWW0000000S00WWWWWWWWWWWWWWWW0000000W
W0000000000WWWWWWWW000000WWWWWWWW000000WWWWWWWW0000000000WWWWWWWWWWWWWWWW0000000W
W00000000000000000000000000000000000000000000000000000000WWWWWWWWWWWWWWWW0000000W
W00000000000000000000S000000000000000000000S00000000000000000000000000000S000000W
W0000000000000000000000000000000000000000000000000000000000000000000000000000000W
WWWW00WWWW00WWWW00WWWW00WWWW00WWWW00WWWW00WWWW00WWWW00WWWW00WWWW00WWWW00WWWW00WWW
WWWW00WWWW00WWWW00WWWW00WWWW00WWWW00WWWW00WWWW00WWWW00WWWW00WWWW00WWWW00WWWW00WWW
WWWW00WWWW00WWWW00WWWW00WWWW00WWWW00WWWW00WWWW00WWWW00WWWW00WWWW00WWWW00WWWW00WWW
WWWW00WWWW00WWWW00WWWW00WWWW00WWWW00WWWW00WWWW00WWWW00WWWW00WWWW00WWWW00WWWW00WWW
W0000000000000000000000000000000000000000000000000000000000000000000000000000000W
W000000000000000000000000000000000S0000000000000000000000000000000S0000000000000W
W0000000000000000000000000000000000000000000000000000000000000000000000000000000W
WWWWWWWWWW000000WWWWWWWWWWWWWWWWWWWWWWWWWWWWWWWWWWWWWWWWWW000000WWWWWWWWWWWWWWWWW
WWWWWWWWWWWWWWWWWWWWWWWWWWWWWWWWWWWWWWWWWWWWWWWWWWWWWWWWWWWWWWWWWWWWWWWWWWWWWWWWW